-!-------------------
| |      |          |
|             |   | |
|  |     |    |   | |
|  | |   |    ||  | |
||              | | |
-----------------*---