---*-------------------------
| | | |           |      || !
| | | |           | ||| ||| |
| | | ||||        |   |     |
|                 |   |||||||
|||||||| | |||||||| |||||||||
|     |  | |                |
|     |  |                  |
|        ||||||||||         |
-----------------------------