-!-------------------
| |      |          |
|             |   | |
|  |     |    |   | |
|  | |   |    ||  | |
||              | | |
-----------------*---
-!-------------------
|@|      |@@@@@@    |
|@@@@@@@@@@   |@  | |
|  |     |    |@@ | |
|  | |   |    ||@@| |
||              |@| |
-----------------*---
