--------
||     !
|| |   |
|| | | |
--*-----