---*-------------------------
| | | |           |      || !
| | | |           | ||| ||| |
| | | ||||        |   |     |
|                 |   |||||||
|||||||| | |||||||| |||||||||
|     |  | |                |
|     |  |                  |
|        ||||||||||         |
-----------------------------
---*-------------------------
| |@| |           |@@@@@ ||@!
| |@| |           |@|||@|||@|
| |@| ||||        |@  |@@@@@|
|  @@@@@@@@       |@  |||||||
|||||||| |@||||||||@|||||||||
|     |  |@|@@@@@@@@        |
|     |  |@@@               |
|        ||||||||||         |
-----------------------------
